2 ++o   + 3
  ++++     
 + + + o+++
++o  ++ ++ 
++ o  + ++ 
o+  ++ +   
 ++o+   + +
o  + +++  +
+ooo+ ++ +o
  o+ +     
0         1
